+--+--+--+--+--+--+--+--+--+--+
|        |     |              |
+  +  +  +  +  +  +--+--+--+  +
|  |  |     |     |           |
+  +--+--+--+--+--+  +--+--+--+
|     |           |           |
+--+  +  +--+--+  +  +--+--+  +
|     |        |  |        |  |
+  +  +--+--+  +  +--+--+  +--+
|  |        |  |  |     |     |
+--+--+--+  +  +  +  +  +--+  +
|           |  |     |        |
+  +--+--+--+--+--+--+--+--+--+
|        |              |     |
+--+--+  +  +--+--+  +--+  +  +
|     |  |     |     |     |  |
+  +  +  +  +  +--+--+  +--+  +
|  |     |  |     |     |     |
+  +--+--+--+--+  +  +  +  +--+
|                    |  |     $
+--+--+--+--+--+--+--+--+--+--+
